R 600 400

NO ./textures/blue.xpm

SO ./textures/brown.xpm

WE ./textures/Red10.xpm

EA ./textures/Slime.xpm

S ./textures/barrel.xpm

F 0,0,0

C 128,128,128

        0011111111111111110111111
        0100000000110000001000001
        0010000011100000010000011
        1001000200000000002000001
111111111111000001110000000000001
100000000011000001110100111111111
10000000200000000000000000001
10000000000000000000000000001
10000001100000222200011000001
1000000110000003000011000001
10000000000000000000000000001
10000000300000000000000000301
10000000000000000000000000001
11110111110111011100000010001
11118111118111811101010010001
11000000110101011100000010001
100010000000020000000000S0001
10000000000000000301010000001
110000011101010111110111100111
11113111 1110101 101111010001
11111111 1111111 111111111111
